1111111111111111111111111111111111111111111111111111111111111111111111111
1E1000000000000000000C0000000000C0C0000000000C10C0000000000C10C00000000C1
1010010100100000101001011111111100010000000000000000000000000000000000111
10100100101010100010010000000101010C0000000000C10C0000000000C10C0000000C1
1P0000000000C0000000000C10C0000000000C10C0000000000C100000000000000000001
1111111111111111111111111111111111111111111111111111111111111111111111111
